name: Psalm 65
tune: Webb

Praise waits for Thee in Zi -- on!
To Thee vows paid shall be.
O God, of prayer the hear -- er,
All flesh shall come to Thee.
In -- i -- qui -- ties are dai -- ly
Pre -- vail -- ing o -- ver me,
But all of our trans -- gres -- sions
Are cov -- ered o'er by Thee.

How blessed the man Thou choos -- est
And bring -- est near to Thee,
That in Thy courts for -- e -- ver
His dwell -- ing place may be.
We shall with -- in Thy tem -- ple
Be whol -- ly sat -- is -- fied
And filled with all the good -- ness
Thy sac -- red courts pro -- vide.

O God of our sal -- va -- tion,
Thou in Thy right -- eous -- ness
With awe -- some deeds and won -- ders
Thine ans -- wer wilt ex -- press,
O Thou in Whom con -- fid -- ing
All ends of earth a -- gree,
And peo -- ple who are sail -- ing
U -- pon the farth -- est sea.

Thy might has built the moun -- tains;
Pow'r clothes Thee ev -- er -- more,
To calm the na -- tions' clam -- or
And still the o -- cean's roar.
Thine awe -- some signs and won -- ders
Fill dist -- ant lands with fear.
Thou mak -- est dawn and sun -- set
For joy to shout and cheer.

Thy vis -- its bring the show -- ers;
Thou dost en -- rich the field.
God's ri -- ver brims with wa -- ter;
Thou dost pre -- pare earth's yield.
Thou wa -- ter -- est earth's fur -- rows;
Clods break down 'neath Thy rain.
Thou soft -- 'nest earth with show -- ers,
To bless each sprout -- ing grain.

Thou crown -- est years with good -- ness;
Thy steps en -- rich the ground.
The des -- ert past -- ures blos -- som;
The hills with joy re -- sound.
The fields with flocks are cov -- ered;
The vales with grain are clad.
They all re -- joice with shout -- ing!
They all with songs are glad!
