name: Psalm 19 (7-14)
tune: Columbia

7_Je -- ho -- vah's per -- fect law
Re -- stores the soul a -- gain:
His test -- i -- mo -- ny sure
Gives wis -- dom un -- to men:
8_The pre -- cepts of the LORD are right,
And fill the heart with great de -- light.

The LORD's com -- mand is pure,
En -- light -- en -- ing the eyes;
9_Je -- ho -- vah's fear is clean,
More last -- ing than the skies.
The judg -- ments of the LORD ex -- press
His truth and per -- fect right -- eous -- ness.

10_They're more to be de -- sired
Than stores of fin -- est gold;
Than hon -- ey from the comb
More sweet -- ness far they hold.
11_With warn -- ings they Thy ser -- vant guard;
In keep -- ing them is great re -- ward.

12_His err -- ors who can know?
Clease me from hid -- den stain.
13_Keep me from will -- ful sins,
Nor let them o'er me reign.
And then I up -- right shall ap -- pear
And be from great trans -- gres -- sion clear.

14_Let all the words I speak
And all the thoughts with -- in
Come up be -- fore Thy sight
And Thine ap -- prov -- al win.
O Thou Jo -- ho -- vah, un -- to me
My rock and my Re -- deem -- er be.
